7 7
5 2 0 0 0 0 6
0 0 1 0 0 0 0
0 0 2 0 0 0 0
1 0 1 0 0 2 0
0 0 0 0 0 0 0
0 0 1 0 0 1 0
8 0 0 0 0 0 7
